ûள  =>  ளை
ûஷ  =>  ஷை
\“  =>  '
\”  =>  '
\‘  =>  '
\’  =>  '
ùஹ  =>  ஹெ
ùஜô  =>  ஜொ
ஷô  =>  ஷா
ஹý  =>  ஹு
ஹþ  =>  ஹூ
ஷþ  =>  ஷூ
ஷý  =>  ஷு
ûஜ  =>  ஜை
ஹô  =>  ஹா
ùஷ  =>  ஷெ
úஜô  =>  ஜோ
ஜô  =>  ஜா
ùஷô  =>  ஷொ
ஜþ  =>  ஜூ
ஜý  =>  ஜு
ளô  =>  ளா
úஹô  =>  ஹோ
ùஜ\[  =>  ஜௌ
ùஜ  =>  ஜெ
\-  =>  லி
úஷô  =>  ஷோ
ûஹ  =>  ஹை
ùஹô  =>  ஹொ
ûஸ  =>  ஸை
ùஷ\[  =>  ஷௌ
ெஸள  =>  ஸௌ
ஸý  =>  ஸு
úஷ  =>  ஷே
ஸô  =>  ஸா
ùஹ\[  =>  ஹௌ
ùக்ஷ\[  =>  க்ஷௌ
úஜ  =>  ஜே
úஹ  =>  ஹே
